5 5 
4 8 7 3 1
2 5 9 8 2
6 3 2 7 3
4 4 1 6 4
6 7 0 1 2